2 13 31
###############################
#p * *2       *   * * *      *#
# # # # #*# # #*# # # # # #*# #
#    * * * * **      *    **  #
# #*# # # # #1# #b#1# # # # #*#
#          *     **      *  **#
# # #*# # # # # #*#*#*#*# # # #
#   *        *   * *x* *      #
# # # # #*# # # # # # #*# #*# #
#      *   3     *1           #
# # # # # # # # # #*# # # # #*#
#   *     *    2              #
###############################